border_size=1
usage=map

Xu          , Xu          , Xu          , Xu          , Xu          , Xu          , Xu          , Xu          , Xu          , Xu          , Xu          , Xu          , Xu          , Xu          , Xu          , Xu          , Xu          , Xu          , Xu          , Xu          , Xu          , Xu          , Xu          , Xu          , Uu          , Xu          
Xu          , Xu          , Xu          , Xu          , Xu          , Xu          , Xu          , Xu          , Uu          , Uu          , Uu          , Xu          , Xu          , Xu          , Xu          , Xu          , Xu          , Xu          , Uu          , Xu          , Uu          , Xu          , Re          , Uu          , Uu          , Uu          
Xu          , Xu          , Xu          , Xu          , Xu          , Xu          , Xu          , Xu          , Uu          , Re          , Re          , Xu          , Xu          , Xu          , Uu          , Uu          , Uu          , Xu          , Uu          , Qxu         , Re          , Re          , Re          , Re          , Uu          , Uu          
Xu          , Xu          , Xu          , Xu          , Re          , Re          , Re          , Re          , Xu          , Uu          , Re          , Xu          , Xu          , Uu          , Uu          , Uu          , Uu          , Uu          , Uu          , Qxu^Bs/     , Uu          , Uu          , Cud         , 2 Kud       , Cud         , Xu          
Xu          , Xu          , Uu          , Re          , Xu          , Uu          , Xu          , Xu          , Uu          , Xu          , Xu          , Uu          , Xu          , Uu          , Re          , Uu          , Re          , Re          , Xu          , Qxu         , Uu          , Re          , Uu          , Cud         , Xu          , Xu          
Xu          , Xu          , Uu          , Xu          , Uh          , Uh          , Uh          , Uu          , Uu          , Uu^Vud      , Uu^Uf       , Xu          , Xu          , Re          , Re          , Uu          , Re          , Re          , Xu          , Qxu         , Re          , Re          , Xu          , Uu          , Xu          , Xu          
Xu          , Xu          , Uu          , Xu          , Uh          , Uh          , Uu          , Xu          , Xu          , Uu          , Uu          , Uu^Uf       , Re          , Xu          , Xu          , Uu          , Re          , Xu          , Xu          , Uu          , Xu          , Xu          , Uu          , Uu          , Uu^Vu       , Xu          
Xu          , Xu          , Xu          , Uu          , Uh          , Uu          , Xu          , Re          , Re          , Uu          , Xu          , Re          , Xu          , Uu          , Uu          , Xu          , Re          , Xu          , Xu          , Uu          , Uu          , Uu          , Uu          , Re          , Re          , Xu          
Xu          , Xu          , Uu^Uf       , Uu^Uf       , Uu^Vud      , Re          , Re          , Xu          , Xu          , Re          , Uu          , Xu          , Xu          , Xu          , Uu          , Uu^Ii       , Xu          , Xu          , Xu          , Xu          , Uu          , Uh          , Uh          , Re          , Uh          , Xu          
Xu          , Xu          , Uh          , Uu^Uf       , Uu^Ii       , Uu          , Xu          , Xu          , Uh          , Xu          , Uu          , Xu          , Re          , Xu          , Uu          , Re          , Re          , Xu          , Uu^Uf       , Xu          , Uu          , Uh          , Uh          , Xu          , Uh          , Xu          
Xu          , Uh          , Uu          , Uh          , Xu          , Xu          , Xu          , Xu          , Uh          , Re          , Xu          , Re          , Xu          , Uu          , Xu          , Xu          , Xu          , Re          , Uu          , Xu          , Re          , Uh          , Uh          , Uh          , Ql          , Xu          
Xu          , Xu          , Uu          , Xu          , Xu          , Xu          , Xu          , Uh          , Uh          , Uh          , Re          , Xu          , Xu          , Xu          , Uu          , Uu          , Uu          , Xu          , Xu          , Uu          , Re          , Uu^Vu       , Uh          , Ql          , Xu          , Xu          
Xu          , Uu          , Re          , Xu          , Xu          , Xu          , Xu          , Uh          , Uh          , Xu          , Uu          , Uu          , Uu          , Xu          , Re          , Xu          , Xu          , Xu          , Xu          , Re          , Re          , Ql          , Ql          , Uh          , Xu          , Xu          
Xu          , Uu          , Re          , Xu          , Uu          , Xu          , Re          , Xu          , Xu          , Xu          , Xu          , Uu          , Re          , Uu          , Re          , Xu          , Xu          , Xu          , Xu          , Xu          , Uu          , Re          , Ql^Bs/      , Uh          , Ql          , Xu          
Xu          , Xu          , Uu          , Re          , Xu          , Uu          , Xu          , Re          , Re          , Re          , Re          , Xu          , Re          , Xu          , Xu          , Re          , Uu          , Xu          , Xu          , Uu^Uf       , Uu          , Uu          , Ql          , Ql^Bs|      , Ql          , Xu          
Xu          , Uu          , Xu          , Re          , Re          , Xu          , Re          , Re          , Xu          , Uu          , Re          , Re          , Uu          , Xu          , Xu          , Xu          , Uu          , Xu          , Uu^Ii       , Re          , Xu          , Xu          , Xu          , Uu          , Uu          , Xu          
Xu          , Uu          , Xu          , Xu          , Xu          , Xu          , Uu          , Xu          , Xu          , Uu          , Uu          , Xu          , Uu          , Uu^Vud      , Uu          , Uu          , Re          , Re          , Uu          , Uu          , Re          , Re          , Xu          , Uu          , Uu          , Xu          
Xu          , Re          , Re          , Xu          , Xu          , Uu          , Re          , Xu          , Xu          , Xu          , Uu          , Xu          , Re          , Uu          , Xu          , Uu          , Xu          , Re          , Uu          , Xu          , Xu          , Re          , Xu          , Xu          , Uu          , Uu          
Xu          , Xu          , Xu          , Uu          , Xu          , Xu          , Re          , Re          , Xu          , Xu          , Uu          , Re          , Xu          , Xu          , Re          , Uu          , Xu          , Uu          , Re          , Xu          , Re          , Re          , Uu          , Uu          , Xu          , Xu          
Xu          , Xu          , Xu          , Re          , Re          , Xu          , Re          , Re          , Uu^Vu       , Xu          , Xu          , Xu          , Qxu         , Xu          , Re          , Xu          , Uu          , Re          , Xu          , Xu          , Re          , Re          , Xu          , Xu          , Xu          , Xu          
Xu          , Xu          , Xu          , Xu          , Uu^Vud      , Uu          , Uu^Uf       , Uu^Uf       , Uu^Uf       , Uu          , Re          , Uu          , Re          , Qxu^Bs/     , Qxu         , Xu          , Xu          , Re          , Xu          , Xu          , Xu          , Re          , Uu          , Xu          , Xu          , Xu          
Xu          , Xu          , Uu          , Uu^Ii       , Uh          , Uh          , Uu^Uf       , Uu^Uf       , Uu          , Re          , Xu          , Xu          , Xu          , Re          , Uu          , Xu          , Xu          , Uu          , Uu          , Xu          , Re          , Xu          , Uu          , Xu          , Xu          , Xu          
Uu          , Uu          , Uh          , Uh          , Ce          , Ce          , Ce          , Uu          , Uu          , Re          , Uu          , Xu          , Xu          , Uu          , Re          , Re          , Re          , Xu          , Re          , Re          , Uh          , Re          , Re          , Xu          , Xu          , Xu          
Re          , Uh          , Uh          , Uh          , Ce          , 1 Ke        , Ce          , Uh          , Uh          , Uu^Vud      , Uh          , Xu          , Re          , Uu          , Xu          , Uh          , Uh          , Uh          , Uh          , Uh          , Uu          , Re          , Re          , Xu          , Xu          , Xu          
Re          , Uu          , Re          , Uu          , Uu          , Ce          , Uu          , Uh          , Uh          , Uu          , Uh          , Uu          , Uu          , Xu          , Xu          , Xu          , Xu          , Uh          , Xu          , Xu          , Xu          , Re          , Re          , Xu          , Xu          , Xu          
Re          , Re          , Re          , Re          , Uu          , Uu          , Uu          , Uh          , Uu          , Uu          , Uu          , Uu          , Xu          , Xu          , Xu          , Xu          , Xu          , Xu          , Xu          , Xu          , Xu          , Uu          , Re          , Uu          , Xu          , Xu          
